цветки	цветок	s	m,nom,pl
дикорастущих	дикорастущий	a	gen,pl
форм	форма	s	f,gen,pl
обыкновенной	обыкновенный	a	f,gen,sg
сирени	сирень	s	f,gen,sg
мелкие	мелкий	a	nom,pl
собраны	собрать	v	brev,nom,partcp,pass,past,pl
парными	парный	a	ins,pl
пучками	пучок	s	ins,m,pl
по	по	pr	
цветков	цветок	s	gen,m,pl
в	в	pr	
пучке	пучок	s	loc,m,sg
отдельные	отдельный	a	nom,pl
сорта	сорт	s	m,nom,pl
по	по	pr	
цветков	цветок	s	gen,m,pl
в	в	pr	
конце	конец	s	loc,m,sg
осени	осень	s	f,gen,sg
кора	кора	s	f,nom,sg
побегов	побег	s	gen,m,pl
становится	становиться	v	3p,pres,sg
серой	серый	a	f,ins,sg
в	в	pr	
центре	центр	s	loc,m,sg
цветка	цветок	s	gen,m,sg
бело-кремовое	белый-кремовый	a	n,nom,sg
пятнышко	пятнышко	s	n,nom,sg
в	в	pr	
виде	вид	s	loc,m,sg
звездочки	звездочка	s	f,gen,sg
при	при	pr	
уплотнении	уплотнение	s	loc,n,sg
почвы	почва	s	f,gen,sg
и	и	conj	
асфальтировании	асфальтирование	s	loc,n,sg
суховершинит	суховершинить	v	3p,pres,sg
морозостоек	морозостойкий	a	brev,m,nom,sg
родина	родина	s	f,nom,sg
горные	горный	a	nom,pl
леса	лес	s	m,nom,pl
тянь-шаня	тянь-шань	s	gen,m,sg
дико	дико	adv	
растет	расти	v	3p,pres,sg
на	на	pr	
сухих	сухой	a	loc,pl
склонах	склон	s	loc,m,pl
в	в	pr	
умеренно	умеренно	adv	
теплых	теплый	a	loc,pl
районах	район	s	loc,m,pl
на	на	pr	
обширной	обширный	a	f,loc,sg
территории	территория	s	f,loc,sg
от	от	pr	
западной	западный	a	f,gen,sg
европы	европа	s	f,gen,sg
до	до	pr	
восточной	восточный	a	f,gen,sg
азии	азия	s	f,gen,sg
полученное	получить	v	acc,n,partcp,pass,past,sg
количество	количество	s	acc,n,sg
саженцев	саженец	s	gen,m,pl
затем	затем	adv	
распределяют	распределять	v	3p,pl,pres
пропорционально	пропорционально	adv	
объему	объем	s	dat,m,sg
работ	работа	s	f,gen,pl
по	по	pr	
годам	год	s	dat,m,pl
перспективного	перспективный	a	gen,n,sg
периода	период	s	gen,m,sg
и	и	conj	
вычисляют	вычислять	v	3p,pl,pres
среднегодовую	среднегодовой	a	acc,f,sg
потребность	потребность	s	acc,f,sg
дистальнее	дистально	adv	comp
места	место	s	gen,n,sg
сужения	сужение	s	gen,n,sg
проток	проток	s	m,nom,sg
не	не	adv	
визуализируется	визуализировать	v	3p,pres,sg
заключение	заключение	s	n,nom,sg
инфильтративные	инфильтративный	a	nom,pl
изменения	изменение	s	n,nom,pl
в	в	pr	
зоне	зона	s	f,loc,sg
гепатикоэнтероанастомоза	гепатикоэнтероанастомоз	s	gen,m,sg
в	в	pr	
воротах	ворота	s	loc,pl
печени	печень	s	f,gen,sg
во	во	pr	
внутрибрюшной	внутрибрюшной	a	f,loc,sg
жировой	жировой	a	f,loc,sg
клетчатке	клетчатка	s	f,loc,sg
золотовалютные	золотовалютный	a	nom,pl
резервы	резерв	s	m,nom,pl
увеличились	увеличиться	v	past,pl
на	на	pr	
миллиардов	миллиард	s	gen,m,pl
долларов	доллар	s	gen,m,pl
и	и	conj	
приближаются	приближаться	v	3p,pl,pres
к	к	pr	
отметке	отметка	s	dat,f,sg
в	в	pr	
полтриллиона	полтриллиона	s	acc,m,sg
долларов	доллар	s	gen,m,pl
сша	сша	s	gen,pl
точнее	точно	adv	comp
по	по	pr	
последним	последний	a	dat,pl
данным	данные	a	dat,pl
чуть-чуть	чуть-чуть	adv	
понижение	понижение	s	n,nom,sg
произошло	произойти	v	n,past,sg
в	в	pr	
связи	связь	s	f,loc,sg
с	с	pr	
изменением	изменение	s	ins,n,sg
курса	курс	s	gen,m,sg
доллара	доллар	s	gen,m,sg
это	это	adv	
вершина	вершина	s	f,nom,sg
тесного	тесный	a	gen,m,sg
и	и	conj	
плодотворного	плодотворный	a	gen,m,sg
сотрудничества	сотрудничество	s	gen,n,sg
между	между	pr	
нашими	наш	apro	ins,pl
странами	страна	s	f,ins,pl
мы	мы	spro	1p,nom,pl
еще	еще	adv	
некоторое	некоторый	apro	acc,n,sg
время	время	s	acc,n,sg
разговариваем	разговаривать	v	1p,pl,pres
с	с	pr	
епископом	епископ	s	ins,m,sg
лукианом	лукиан	s	ins,m,sg
потом	потом	adv	
он	он	spro	3p,m,nom,sg
провожает	провожать	v	3p,pres,sg
меня	я	spro	1p,acc,sg
до	до	pr	
ворот	ворота	s	gen,pl
резиденции	резиденция	s	f,gen,sg
откуда	откуда	adv	
навстречу	навстречу	adv	
нам	мы	spro	1p,dat,pl
идет	идти	v	3p,pres,sg
многочисленный	многочисленный	a	m,nom,sg
и	и	conj	
многоязычный	многоязычный	a	m,nom,sg
поток	поток	s	m,nom,sg
людей	человек	s	gen,m,pl
желающих	желать	v	act,gen,partcp,pl,pres
осмотреть	осмотреть	v	inf
экспонаты	экспонат	s	acc,m,pl
православного	православный	a	gen,m,sg
музея	музей	s	gen,m,sg
и	и	conj	
посетить	посетить	v	inf
кафедральный	кафедральный	a	acc,m,sg
собор	собор	s	acc,m,sg
многотысячный	многотысячный	a	m,nom,sg
коллектив	коллектив	s	m,nom,sg
газпрома	газпром	s	gen,m,sg
денно	денно	adv	
и	и	conj	
нощно	нощно	adv	
трудился	трудиться	v	m,past,sg
над	над	pr	
поставленной	поставить	v	f,ins,partcp,pass,past,sg
задачей	задача	s	f,ins,sg
там	там	adv	
оставалось	оставаться	v	n,past,sg
еще	еще	adv	
сербских	сербский	a	gen,pl
сел	село	s	gen,n,pl
мы	мы	spro	1p,nom,pl
шли	идти	v	past,pl
в	в	pr	
бой	бой	s	acc,m,sg
вместе	вместе	adv	
и	и	conj	
готовы	готовый	a	brev,nom,pl
были	быть	v	past,pl
пролить	пролить	v	inf
кровь	кровь	s	acc,f,sg
друг	друг	s	m,nom,sg
за	за	pr	
друга	друг	s	acc,m,sg
какие	какой	apro	nom,pl
впечатления	впечатление	s	n,nom,pl
у	у	pr	
вас	вы	spro	2p,gen,pl
остались	остаться	v	past,pl
от	от	pr	
москвы	москва	s	f,gen,sg
в	в	pr	
году	год	s	loc,m,sg
по	по	pr	
удивительному	удивительный	a	dat,m,sg
стечению	стечение	s	dat,n,sg
обстоятельств	обстоятельство	s	gen,n,pl
ваш	ваш	apro	m,nom,sg
олимпийский	олимпийский	a	m,nom,sg
триумф	триумф	s	m,nom,sg
идеально	идеально	adv	
совпал	совпасть	v	m,past,sg
по	по	pr	
времени	время	s	dat,n,sg
с	с	pr	
внедрением	внедрение	s	ins,n,sg
современных	современный	a	gen,pl
поролоновых	поролоновый	a	gen,pl
матов	мат	s	gen,m,pl
все	весь	apro	acc,n,sg
поселение	поселение	s	acc,n,sg
можно	можно	adv	
обойти	обойти	v	inf
неторопливым	неторопливый	a	ins,m,sg
шагом	шаг	s	ins,m,sg
за	за	pr	
минут	минута	s	f,gen,pl
стабильное	стабильный	a	n,nom,sg
взаимодействие	взаимодействие	s	n,nom,sg
в	в	pr	
нефтегазовом	нефтегазовый	a	loc,m,sg
секторе	сектор	s	loc,m,sg
является	являться	v	3p,pres,sg
общим	общий	a	ins,m,sg
вкладом	вклад	s	ins,m,sg
россии	россия	s	f,gen,sg
и	и	conj	
венгрии	венгрия	s	f,gen,sg
в	в	pr	
обеспечение	обеспечение	s	acc,n,sg
энергобезопасности	энергобезопасность	s	f,gen,sg
европы	европа	s	f,gen,sg
при	при	pr	
этом	это	spro	loc,n,sg
работа	работа	s	f,nom,sg
над	над	pr	
реализаций	реализация	s	f,gen,pl
проектов	проект	s	gen,m,pl
жестко	жестко	adv	
увязывалась	увязываться	v	f,past,sg
с	с	pr	
достижением	достижение	s	ins,n,sg
на	на	pr	
каждом	каждый	apro	loc,m,sg
этапе	этап	s	loc,m,sg
целевых	целевой	a	gen,pl
показателей	показатель	s	gen,m,pl
наверняка	наверняка	adv	
техника	техника	s	f,nom,sg
была	быть	v	f,past,sg
бы	бы	adv	
уже	уже	adv	
не	не	adv	
та	тот	apro	f,nom,sg
я	я	spro	1p,nom,sg
имею	иметь	v	1p,pres,sg
в	в	pr	
виду	вид	s	loc,m,sg
наше	наш	apro	acc,n,sg
сотрудничество	сотрудничество	s	acc,n,sg
в	в	pr	
сфере	сфера	s	f,loc,sg
энергетики	энергетика	s	f,gen,sg
первый	первый	anum	m,nom,sg
блок	блок	s	m,nom,sg
сангтудинской	сангтудинский	a	f,gen,sg
гэс	гэс	s	f,gen,sg
станции	станция	s	f,gen,sg
запущен	запустить	v	m,nom,partcp,pass,past,sg
в	в	pr	
январе	январь	s	loc,m,sg
в	в	pr	
рамках	рамка	s	f,loc,pl
национального	национальный	a	gen,m,sg
проекта	проект	s	gen,m,sg
миллионов	миллион	s	gen,m,pl
человек	человек	s	gen,m,pl
смогли	смочь	v	past,pl
пройти	пройти	v	inf
диспансеризацию	диспансеризация	s	acc,f,sg
а	а	conj	
миллионам	миллион	s	dat,m,pl
были	быть	v	past,pl
сделаны	сделать	v	brev,nom,partcp,pass,past,pl
прививки	прививка	s	f,nom,pl
оба	оба	num	m,nom
работают	работать	v	3p,pl,pres
на	на	pr	
влиятельную	влиятельный	a	acc,f,sg
и	и	conj	
известную	известный	a	acc,f,sg
адвокатскую	адвокатский	a	acc,f,sg
контору	контора	s	acc,f,sg
и	и	conj	
успешно	успешно	adv	
продвигаются	продвигаться	v	3p,pl,pres
по	по	pr	
служебной	служебный	a	dat,f,sg
лестнице	лестница	s	dat,f,sg
некоторые	некоторый	apro	nom,pl
люди	человек	s	m,nom,pl
испытывают	испытывать	v	3p,pl,pres
панические	панический	a	acc,pl
атаки	атака	s	acc,f,pl
которые	который	apro	nom,pl
характеризуются	характеризовать	v	3p,pl,pres
чрезвычайно	чрезвычайно	adv	
сильным	сильный	a	ins,n,sg
чувством	чувство	s	ins,n,sg
страха	страх	s	gen,m,sg
они	они	spro	3p,nom,pl
отнюдь	отнюдь	adv	
не	не	adv	
редки	редкий	a	brev,nom,pl
к	к	pr	
третьей	третий	anum	dat,f,sg
неделе	неделя	s	dat,f,sg
пациенты	пациент	s	m,nom,pl
показывали	показывать	v	past,pl
заметное	заметный	a	acc,n,sg
улучшение	улучшение	s	acc,n,sg
настроения	настроение	s	gen,n,sg
в	в	pr	
отличие	отличие	s	acc,n,sg
от	от	pr	
принимавших	принимать	v	act,gen,partcp,past,pl
плацебо	плацебо	s	acc,n,sg
высокий	высокий	a	m,nom,sg
уровень	уровень	s	m,nom,sg
эстрогена	эстроген	s	gen,m,sg
и	и	conj	
низкий	низкий	a	m,nom,sg
прогестерона	прогестерон	s	gen,m,sg
могут	мочь	v	3p,pl,pres
привести	привести	v	inf
к	к	pr	
предменструальному	предменструальный	a	dat,m,sg
синдрому	синдром	s	dat,m,sg
пмс	пмс	s	dat,m,sg
с	с	pr	
цикличной	цикличный	a	f,ins,sg
депрессией	депрессия	s	f,ins,sg
и	и	conj	
беспокойством	беспокойство	s	ins,n,sg
иногда	иногда	adv	
колебания	колебание	s	n,nom,pl
настроения	настроение	s	gen,n,sg
и	и	conj	
депрессия	депрессия	s	f,nom,sg
могут	мочь	v	3p,pl,pres
быть	быть	v	inf
результатом	результат	s	ins,m,sg
слишком	слишком	adv	
большого	большой	a	gen,m,sg
стресса	стресс	s	gen,m,sg
и	и	conj	
истощения	истощение	s	gen,n,sg
надпочечников	надпочечник	s	gen,m,pl
первое	первый	anum	n,nom,sg
описание	описание	s	n,nom,sg
этого	этот	apro	gen,m,sg
члена	член	s	gen,m,sg
семейства	семейство	s	gen,n,sg
перечных	перечный	a	gen,pl
появилось	появиться	v	n,past,sg
в	в	pr	
западных	западный	a	loc,pl
странах	страна	s	f,loc,pl
после	после	pr	
знаменитых	знаменитый	a	gen,pl
рейдов	рейд	s	gen,m,pl
капитана	капитан	s	gen,m,sg
джеймса	джеймс	s	gen,m,sg
кука	кук	s	gen,m,sg
в	в	pr	
южные	южный	a	acc,pl
моря	море	s	acc,n,pl
согласно	согласно	pr	
данным	данные	s	dat,pl
национального	национальный	a	gen,n,sg
аутистического	аутистический	a	gen,n,sg
общества	общество	s	gen,n,sg
частота	частота	s	f,nom,sg
аутизма	аутизм	s	gen,m,sg
сейчас	сейчас	adv	
может	мочь	v	3p,pres,sg
превышать	превышать	v	inf
случай	случай	s	acc,m,sg
на	на	pr	
каждые	каждый	apro	acc,pl
детей	ребенок	s	gen,m,pl
конечная	конечный	a	f,nom,sg
цель	цель	s	f,nom,sg
математики	математика	s	f,gen,sg
вообще	вообще	adv	
избавиться	избавиться	v	inf
от	от	pr	
необходимости	необходимость	s	f,gen,sg
о	о	pr	
чем-либо	что-либо	spro	loc,n
думать	думать	v	inf
в	в	pr	
том-то	то-то	spro	loc,n,sg
и	и	conj	
дело	дело	s	n,nom,sg
что	что	conj	
кроме	кроме	pr	
действительных	действительный	a	gen,pl
чисел	число	s	gen,n,pl
достаточно	достаточно	adv	
изобрести	изобрести	v	inf
только	только	adv	
одно	один	anum	acc,n,sg
число	число	s	acc,n,sg
квадратный	квадратный	a	acc,m,sg
корень	корень	s	acc,m,sg
из	из	pr	
после	после	pr	
этого	это	spro	gen,n,sg
можно	можно	adv	
решить	решить	v	inf
любое	любой	apro	acc,n,sg
алгебраическое	алгебраический	a	acc,n,sg
уравнение	уравнение	s	acc,n,sg
возможные	возможный	a	nom,pl
состояния	состояние	s	n,nom,pl
электронов	электрон	s	gen,m,pl
определяются	определять	v	3p,pl,pres
различными	различный	a	ins,pl
энергетическими	энергетический	a	ins,pl
подуровнями	подуровень	s	ins,m,pl
которые	который	apro	nom,pl
носят	носить	v	3p,pl,pres
название	название	s	acc,n,sg
орбиталей	орбиталь	s	f,gen,pl
указанный	указать	v	m,nom,partcp,pass,past,sg
выше	высоко	adv	comp
вызов	вызов	s	m,nom,sg
функции	функция	s	f,gen,sg
вернет	вернуть	v	3p,pres,sg
все	весь	apro	acc,pl
объекты	объект	s	acc,m,pl
из	из	pr	
агента	агент	s	gen,m,sg
напущенного	напустить	v	gen,m,partcp,pass,past,sg
на	на	pr	
локальном	локальный	a	loc,m,sg
хосте	хост	s	loc,m,sg
эта	этот	apro	f,nom,sg
группа	группа	s	f,nom,sg
включает	включать	v	3p,pres,sg
щелочные	щелочной	a	acc,pl
металлы	металл	s	acc,m,pl
натрий	натрий	s	acc,m,sg
и	и	conj	
калий	калий	s	acc,m,sg
щелочноземельные	щелочноземельный	a	acc,pl
металлы	металл	s	acc,m,pl
магний	магний	s	acc,m,sg
и	и	conj	
кальций	кальций	s	acc,m,sg
это	это	spro	n,nom,sg
сразу	сразу	adv	
говорит	говорить	v	3p,pres,sg
нам	мы	spro	1p,dat,pl
что	что	spro	n,nom
такое	такой	apro	n,nom,sg
момент	момент	s	m,nom,sg
количественно	количественно	adv	
собачка	собачка	s	f,nom,sg
нужна	нужный	a	brev,f,nom,sg
к	к	pr	
празднику	праздник	s	dat,m,sg
он	он	spro	3p,m,nom,sg
полагал	полагать	v	m,past,sg
что	что	conj	
римлян	римлянин	s	acc,m,pl
сгубило	сгубить	v	n,past,sg
избыточное	избыточный	a	n,nom,sg
честолюбие	честолюбие	s	n,nom,sg
енл-1	енл-1	s	acc,f,pl
получают	получать	v	3p,pl,pres
общенациональные	общенациональный	a	nom,pl
и	и	conj	
крупные	крупный	a	nom,pl
региональные	региональный	a	nom,pl
газеты	газета	s	f,nom,pl
и	и	conj	
телекомпании	телекомпания	s	f,nom,pl
агентства	агентство	s	n,nom,pl
иностранные	иностранный	a	nom,pl
дипломатические	дипломатический	a	nom,pl
представительства	представительство	s	n,nom,pl
в	в	pr	
россии	россия	s	f,loc,sg
телевизионные	телевизионный	a	nom,pl
web-технологии	web-технология	s	f,nom,pl
развиваются	развиваться	v	3p,pl,pres
в	в	pr	
нашей	наш	apro	f,loc,sg
стране	страна	s	f,loc,sg
с	с	pr	
некоторым	некоторый	apro	ins,n,sg
опозданием	опоздание	s	ins,n,sg
недели	неделя	s	f,gen,sg
через	через	pr	
две-три	два-три	num	acc,f
не	не	adv	
раньше	рано	adv	comp
такой	такой	apro	f,gen,sg
птицы	птица	s	f,gen,sg
не	не	adv	
водилось	водиться	v	n,past,sg
в	в	pr	
здешних	здешний	a	loc,pl
местах	место	s	loc,n,pl
здесь	здесь	adv	
он	он	spro	3p,m,nom,sg
не	не	adv	
отказал	отказать	v	m,past,sg
себе	себя	spro	dat
в	в	pr	
удовольствии	удовольствие	s	loc,n,sg
заранее	заранее	adv	
злорадно	злорадно	adv	
вообразить	вообразить	v	inf
как	как	adv	
будет	быть	v	3p,pres,sg
сходить	сходить	v	inf
со	со	pr	
сцены	сцена	s	f,gen,sg
премьер	премьер	s	m,nom,sg
борзых	борзых	s	m,nom,sg
булькнуло	булькнуть	v	n,past,sg
екнуло	екнуть	v	n,past,sg
порскнуло	порскнуть	v	n,past,sg
ахнуло	ахнуть	v	n,past,sg
лучше	хорошо	adv	comp
гляди	глядеть	v	2p,imper,sg
сзади	сзади	adv	
наверху	наверху	adv	
вниз	вниз	adv	
головой	голова	s	f,ins,sg
пропало	пропасть	v	n,past,sg
нету	нету	adv	
и	и	conj	
пэт	пэт	s	f,nom,sg
выла	выть	v	f,past,sg
от	от	pr	
злости	злость	s	f,gen,sg
ее	ее	apro	
грегори	грегори	s	m,nom,sg
ее	ее	apro	
лучезарный	лучезарный	a	m,nom,sg
муж	муж	s	m,nom,sg
был	быть	v	m,past,sg
тоже	тоже	adv	
во	во	pr	
власти	власть	s	f,loc,sg
этого	этот	apro	gen,m,sg
всемогущего	всемогущий	a	gen,m,sg
микрооргазма	микрооргазм	s	gen,m,sg
он	он	spro	3p,m,nom,sg
засыпал	засыпать	v	m,past,sg
ухватившись	ухватиться	v	ger,past
за	за	pr	
ее	ее	apro	
пальцы	палец	s	acc,m,pl
и	и	conj	
оставляя	оставлять	v	ger,pres
его	он	spro	3p,acc,m,sg
надо	надо	adv	
было	быть	v	n,past,sg
с	с	pr	
величайшей	величайший	a	f,ins,sg
осторожностью	осторожность	s	f,ins,sg
высвобождать	высвобождать	v	inf
руку	рука	s	acc,f,sg
чтобы	чтобы	conj	
он	он	spro	3p,m,nom,sg
не	не	adv	
проснулся	проснуться	v	m,past,sg
с	с	pr	
криком	крик	s	ins,m,sg
ужаса	ужас	s	gen,m,sg
хотел	хотеть	v	m,past,sg
бы	бы	adv	
добавить	добавить	v	inf
разумное	разумный	a	acc,n,sg
как	как	adv	
может	мочь	v	3p,pres,sg
инженер	инженер	s	m,nom,sg
что-нибудь	что-нибудь	spro	acc
портить	портить	v	inf
не	не	adv	
сотвори	сотворить	v	2p,imper,sg
себе	себя	spro	dat
кумира	кумир	s	acc,m,sg
но	но	conj	
лишь	лишь	adv	
люби	любить	v	2p,imper,sg
как	как	conj	
я	я	spro	1p,nom,sg
люблю	любить	v	1p,pres,sg
в	в	pr	
твоем	твой	apro	loc,n,sg
подобье	подобье	s	loc,n,sg
образ	образ	s	acc,m,sg
мира	мир	s	gen,m,sg
и	и	conj	
не	не	adv	
скорби	скорбеть	v	2p,imper,sg
как	как	conj	
я	я	spro	1p,nom,sg
скорблю	скорбеть	v	1p,pres,sg
я	я	spro	1p,nom,sg
заставил	заставить	v	m,past,sg
ее	она	spro	3p,acc,f,sg
повторить	повторить	v	inf
задание	задание	s	acc,n,sg
тут	тут	adv	
на	на	pr	
кухню	кухня	s	acc,f,sg
явилась	явиться	v	f,past,sg
майка	майка	s	f,nom,sg
а	а	conj	
вы	вы	spro	2p,nom,pl
разбудите	разбудить	v	2p,pl,pres
нас	мы	spro	1p,acc,pl
если	если	conj	
новый	новый	a	m,nom,sg
цыпленок	цыпленок	s	m,nom,sg
выведется	вывестись	v	3p,pres,sg
но	но	conj	
на	на	pr	
этот	этот	apro	acc,m,sg
раз	раз	s	acc,m,sg
его	он	spro	3p,gen,m,sg
совсем	совсем	adv	
не	не	adv	
было	быть	v	n,past,sg
тартасов	тартасов	s	m,nom,sg
хитрец	хитрец	s	m,nom,sg
как	как	conj	
все	весь	apro	nom,pl
писатели	писатель	s	m,nom,pl
таков	таков	apro	m,nom,sg
их	их	apro	
удел	удел	s	m,nom,sg
стояли	стоять	v	past,pl
в	в	pr	
кружок	кружок	s	acc,m,sg
и	и	conj	
по-честному	по-честному	adv	
рассуждали	рассуждать	v	past,pl
небо	небо	s	n,nom,sg
в	в	pr	
которое	который	apro	acc,n,sg
можно	можно	adv	
глядеть	глядеть	v	inf
задрав	задрать	v	ger,past
голову	голова	s	acc,f,sg
идти	идти	v	inf
и	и	conj	
думать	думать	v	inf
о	о	pr	
синеве	синева	s	f,loc,sg
внеконфессиональное	внеконфессиональный	a	n,nom,sg
государство	государство	s	n,nom,sg
представляет	представлять	v	3p,pres,sg
собой	себя	spro	acc
государство	государство	s	acc,n,sg
которое	который	apro	n,nom,sg
сознательно	сознательно	adv	
отстраняет	отстранять	v	3p,pres,sg
себя	себя	spro	acc
от	от	pr	
всего	все	spro	gen
что	что	spro	nom
происходит	происходить	v	3p,pres,sg
в	в	pr	
лоне	лоно	s	loc,n,sg
религии	религия	s	f,gen,sg
позволяя	позволять	v	ger,pres
решать	решать	v	inf
эти	этот	apro	acc,pl
вопросы	вопрос	s	acc,m,pl
гражданскому	гражданский	a	dat,n,sg
обществу	общество	s	dat,n,sg
неуведомление	неуведомление	s	n,nom,sg
или	или	conj	
несвоевременное	несвоевременный	a	n,nom,sg
уведомление	уведомление	s	n,nom,sg
об	об	pr	
указанных	указать	v	loc,partcp,pass,past,pl
обстоятельствах	обстоятельство	s	loc,n,pl
лишает	лишать	v	3p,pres,sg
стороны	сторона	s	acc,f,pl
права	право	s	gen,n,sg
ссылаться	ссылаться	v	inf
на	на	pr	
любые	любой	apro	acc,pl
из	из	pr	
этих	этот	apro	gen,pl
обстоятельств	обстоятельство	s	gen,n,pl
и	и	conj	
не	не	adv	
освобождает	освобождать	v	3p,pres,sg
от	от	pr	
ответственности	ответственность	s	f,gen,sg
по	по	pr	
настоящему	настоящий	a	dat,m,sg
договору	договор	s	dat,m,sg
президиум	президиум	s	m,nom,sg
высшего	высший	a	gen,m,sg
арбитражного	арбитражный	a	gen,m,sg
суда	суд	s	gen,m,sg
рф	рф	s	f,gen,sg
в	в	pr	
информационном	информационный	a	loc,n,sg
письме	письмо	s	loc,n,sg
от	от	pr	
сентября	сентябрь	s	gen,m,sg
г.	год	s	gen,m,sg
о	о	pr	
некоторых	некоторый	apro	loc,pl
вопросах	вопрос	s	loc,m,pl
судебной	судебный	a	f,gen,sg
практики	практика	s	f,gen,sg
возникающих	возникать	v	act,loc,partcp,pl,pres
при	при	pr	
рассмотрении	рассмотрение	s	loc,n,sg
споров	спор	s	gen,m,pl
связанных	связывать	v	loc,partcp,pass,past,pl
с	с	pr	
договорами	договор	s	ins,m,pl
на	на	pr	
оказание	оказание	s	acc,n,sg
правовых	правовой	a	gen,pl
услуг	услуга	s	f,gen,pl
отметил	отметить	v	m,past,sg
что	что	conj	
не	не	adv	
подлежат	подлежать	v	3p,pl,pres
удовлетворению	удовлетворение	s	dat,n,sg
требования	требование	s	gen,n,sg
исполнителя	исполнитель	s	gen,m,sg
о	о	pr	
выплате	выплата	s	f,loc,sg
вознаграждения	вознаграждение	s	gen,n,sg
если	если	conj	
истец	истец	s	m,nom,sg
обосновывает	обосновывать	v	3p,pres,sg
их	они	spro	3p,acc,pl
условием	условие	s	ins,n,sg
договора	договор	s	gen,m,sg
ставящим	ставить	v	act,ins,n,partcp,pres,sg
размер	размер	s	acc,m,sg
оплаты	оплата	s	f,gen,sg
услуг	услуга	s	f,gen,pl
в	в	pr	
зависимость	зависимость	s	acc,f,sg
от	от	pr	
решения	решение	s	gen,n,sg
суда	суд	s	gen,m,sg
или	или	conj	
государственного	государственный	a	gen,m,sg
органа	орган	s	gen,m,sg
которое	который	apro	n,nom,sg
будет	быть	v	3p,pres,sg
принято	принять	v	brev,n,nom,partcp,pass,past,sg
в	в	pr	
будущем	будущее	s	loc,n,sg
после	после	pr	
произнесения	произнесение	s	gen,n,sg
речей	речь	s	f,gen,pl
всеми	весь	apro	ins,pl
лицами	лицо	s	ins,n,pl
участвующими	участвовать	v	act,ins,partcp,pl,pres
в	в	pr	
деле	дело	s	loc,n,sg
их	их	apro	
представителями	представитель	s	ins,m,pl
они	они	spro	
могут	мочь	v	3p,pl,pres
выступить	выступить	v	inf
с	с	pr	
репликами	реплика	s	f,ins,pl
в	в	pr	
связи	связь	s	f,loc,sg
со	со	pr	
сказанным	сказать	v	loc,n,partcp,pass,past,sg
протокол	протокол	s	m,nom,sg
судебного	судебный	a	gen,n,sg
заседания	заседание	s	gen,n,sg
или	или	conj	
совершенного	совершать	v	gen,n,partcp,pass,past,sg
вне	вне	pr	
судебного	судебный	a	gen,n,sg
заседания	заседание	s	gen,n,sg
отдельного	отдельный	a	gen,n,sg
процессуального	процессуальный	a	gen,n,sg
действия	действие	s	gen,n,sg
должен	должен	adv	
отражать	отражать	v	inf
все	весь	apro	acc,pl
существенные	существенный	a	acc,pl
сведения	сведение	s	acc,n,pl
о	о	pr	
разбирательстве	разбирательство	s	loc,n,sg
дела	дело	s	gen,n,sg
или	или	conj	
совершении	совершение	s	loc,n,sg
отдельного	отдельный	a	gen,n,sg
процессуального	процессуальный	a	gen,n,sg
действия	действие	s	gen,n,sg
лицо	лицо	s	n,nom,sg
представляющее	представлять	v	act,n,nom,partcp,pres,sg
аудио-	аудиозапись	s	acc,f,pl
и	и	conj	
или	или	conj	
видеозаписи	видеозапись	s	acc,f,pl
на	на	pr	
электронном	электронный	a	loc,m,sg
или	или	conj	
ином	иной	a	loc,m,sg
носителе	носитель	s	loc,m,sg
либо	либо	conj	
ходатайствующее	ходатайствовать	v	act,n,nom,partcp,pres,sg
об	об	pr	
их	их	apro	
истребовании	истребование	s	loc,n,sg
обязано	обязать	v	brev,n,partcp,pass,past,sg
указать	указать	v	inf
когда	когда	adv	
кем	кто	spro	ins
и	и	conj	
в	в	pr	
каких	какой	apro	loc,pl
условиях	условие	s	loc,n,pl
осуществлялись	осуществляться	v	past,pl
записи	запись	s	f,nom,sg
решения	решение	s	n,nom,pl
нижестоящей	нижестоящий	a	f,gen,sg
комиссии	комиссия	s	f,gen,sg
по	по	pr	
проведению	проведение	s	dat,n,sg
референдума	референдум	s	gen,m,sg
российской	российский	a	f,gen,sg
федерации	федерация	s	f,gen,sg
могут	мочь	v	3p,pl,pres
быть	быть	v	inf
отменены	отменить	v	brev,partcp,pass,past,pl
а	а	conj	
ее	ее	apro	
действия	действие	s	n,nom,pl
могут	мочь	v	3p,pl,pres
быть	быть	v	inf
приостановлены	приостановить	v	brev,partcp,pass,past,pl
вышестоящей	вышестоящий	a	f,ins,sg
комиссией	комиссия	s	f,ins,sg
по	по	pr	
проведению	проведение	s	dat,n,sg
референдума	референдум	s	gen,m,sg
российской	российский	a	f,gen,sg
федерации	федерация	s	f,gen,sg
решение	решение	s	n,nom,sg
принятое	принять	v	n,nom,partcp,pass,past,sg
на	на	pr	
референдуме	референдум	s	loc,m,sg
российской	российский	a	f,gen,sg
федерации	федерация	s	f,gen,sg
является	являться	v	3p,pres,sg
общеобязательным	общеобязательный	a	ins,n,sg
и	и	conj	
не	не	adv	
нуждается	нуждаться	v	3p,pres,sg
в	в	pr	
дополнительном	дополнительный	a	loc,n,sg
утверждении	утверждение	s	loc,n,sg
статья	статья	s	f,nom,sg
обособленные	обособить	v	nom,partcp,pass,past,pl
водные	водный	a	nom,pl
объекты	объект	s	m,nom,pl
находящиеся	находиться	v	act,nom,partcp,pl,pres
в	в	pr	
собственности	собственность	s	f,loc,sg
граждан	гражданин	s	gen,m,pl
или	или	conj	
юридических	юридический	a	gen,pl
лиц	лицо	s	gen,n,pl
в	в	pr	
установленном	установить	v	loc,m,partcp,pass,past,sg
порядке	порядок	s	loc,m,sg
могут	мочь	v	3p,pl,pres
использоваться	использоваться	v	inf
как	как	conj	
водные	водный	a	nom,pl
объекты	объект	s	m,nom,pl
общего	общий	a	gen,n,sg
пользования	пользование	s	gen,n,sg
только	только	adv	
при	при	pr	
условиях	условие	s	loc,n,pl
регистрации	регистрация	s	f,gen,sg
данного	данный	a	gen,n,sg
ограничения	ограничение	s	gen,n,sg
права	право	s	gen,n,sg
собственности	собственность	s	f,gen,sg
на	на	pr	
обособленные	обособить	v	acc,partcp,pass,past,pl
водные	водный	a	acc,pl
объекты	объект	s	acc,m,pl
в	в	pr	
едином	единый	a	loc,m,sg
государственном	государственный	a	loc,m,sg
реестре	реестр	s	loc,m,sg
и	и	conj	
выплаты	выплата	s	f,gen,sg
вознаграждения	вознаграждение	s	gen,n,sg
собственнику	собственник	s	dat,m,sg
государственный	государственный	a	m,nom,sg
мониторинг	мониторинг	s	m,nom,sg
водных	водный	a	gen,pl
объектов	объект	s	gen,m,pl
ведется	вестись	v	3p,pres,sg
специально	специально	adv	
уполномоченным	уполномочить	v	ins,m,partcp,pass,past,sg
государственным	государственный	a	ins,m,sg
органом	орган	s	ins,m,sg
управления	управление	s	gen,n,sg
использованием	использование	s	ins,n,sg
и	и	conj	
охраной	охрана	s	f,ins,sg
водного	водный	a	gen,m,sg
фонда	фонд	s	gen,m,sg
совместно	совместно	adv	
со	со	pr	
специально	специально	adv	
уполномоченными	уполномочить	v	ins,partcp,pass,past,pl
государственными	государственный	a	ins,pl
органами	орган	s	ins,m,pl
в	в	pr	
области	область	s	f,loc,sg
охраны	охрана	s	f,gen,sg
окружающей	окружать	v	act,f,gen,partcp,pres,sg
природной	природный	a	f,gen,sg
среды	среда	s	f,gen,sg
с	с	pr	
государственным	государственный	a	ins,m,sg
органом	орган	s	ins,m,sg
управления	управление	s	gen,n,sg
в	в	pr	
области	область	s	f,loc,sg
гидрометеорологии	гидрометеорология	s	f,gen,sg
и	и	conj	
мониторинга	мониторинг	s	gen,m,sg
окружающей	окружать	v	act,f,gen,partcp,pres,sg
среды	среда	s	f,gen,sg
по	по	pr	
поверхностным	поверхностный	a	dat,pl
водным	водный	a	dat,pl
объектам	объект	s	dat,m,pl
и	и	conj	
государственным	государственный	a	ins,m,sg
органом	орган	s	ins,m,sg
управления	управление	s	gen,n,sg
использованием	использование	s	ins,n,sg
и	и	conj	
охраной	охрана	s	f,ins,sg
недр	недра	s	gen,pl
по	по	pr	
подземным	подземный	a	dat,pl
водным	водный	a	dat,pl
объектам	объект	s	dat,m,pl
фиктивное	фиктивный	a	n,nom,sg
или	или	conj	
преднамеренное	преднамеренный	a	n,nom,sg
банкротство	банкротство	s	n,nom,sg
осуществление	осуществление	s	n,nom,sg
дисквалифицированным	дисквалифицированный	a	ins,n,sg
лицом	лицо	s	ins,n,sg
в	в	pr	
течение	течение	s	acc,n,sg
срока	срок	s	gen,m,sg
дисквалификации	дисквалификация	s	f,gen,sg
деятельности	деятельность	s	f,gen,sg
по	по	pr	
управлению	управление	s	dat,n,sg
юридическим	юридический	a	ins,n,sg
лицом	лицо	s	ins,n,sg
